    ________
    |      \\|
    o        |
   /|\\      |
    |        |
   / \\      |
 ____________|_____

