    ________
    |      \\|
    x        |
   /|\\      |
    |        |
   / \\      |
 ____________|_____
