    ________
    |      \\|
    o        |
   /|\\      |
    |        |
   /         |
 ____________|_____

